Field Name	Parse statement	Description	Sample value from Log
resource_accessKeyDetails_accessKeyId	json_extract(resource, "$.accessKeyDetails.accessKeyId")	
resource_accessKeyDetails_principalId	json_extract(resource, "$.accessKeyDetails.principalId")	
resource_accessKeyDetails_userName	json_extract(resource, "$.accessKeyDetails.userName")	
resource_accessKeyDetails_userType	json_extract(resource, "$.accessKeyDetails.userType")	
resource_containerDetails_containerRuntime	json_extract(resource, "$.containerDetails.containerRuntime")	
resource_containerDetails_id	json_extract(resource, "$.containerDetails.id")	
resource_containerDetails_image	json_extract(resource, "$.containerDetails.image")	
resource_containerDetails_imagePrefix	json_extract(resource, "$.containerDetails.imagePrefix")	
resource_containerDetails_imageUid	json_extract(resource, "$.containerDetails.imageUid")	
resource_containerDetails_name	json_extract(resource, "$.containerDetails.name")	
resource_containerDetails_securityContext_privileged	json_extract(resource, "$.containerDetails.securityContext.privileged")	
resource_containerDetails_volumeMounts_mountPath	json_extract(resource, "$.containerDetails.volumeMounts.mountPath")	
resource_containerDetails_volumeMounts_name	json_extract(resource, "$.containerDetails.volumeMounts.name")	
resource_ebsVolumeDetails_scannedVolumeDetails_deviceName	json_extract(resource, "$.ebsVolumeDetails.scannedVolumeDetails.deviceName")	
resource_ebsVolumeDetails_scannedVolumeDetails_encryptionType	json_extract(resource, "$.ebsVolumeDetails.scannedVolumeDetails.encryptionType")	
resource_ebsVolumeDetails_scannedVolumeDetails_kmsKeyArn	json_extract(resource, "$.ebsVolumeDetails.scannedVolumeDetails.kmsKeyArn")	
resource_ebsVolumeDetails_scannedVolumeDetails_snapshotArn	json_extract(resource, "$.ebsVolumeDetails.scannedVolumeDetails.snapshotArn")	
resource_ebsVolumeDetails_scannedVolumeDetails_volumeArn	json_extract(resource, "$.ebsVolumeDetails.scannedVolumeDetails.volumeArn")	
resource_ebsVolumeDetails_scannedVolumeDetails_volumeSizeInGB	json_extract(resource, "$.ebsVolumeDetails.scannedVolumeDetails.volumeSizeInGB")	
resource_ebsVolumeDetails_scannedVolumeDetails_volumeType	json_extract(resource, "$.ebsVolumeDetails.scannedVolumeDetails.volumeType")	
resource_ebsVolumeDetails_skippedVolumeDetails	json_extract(resource, "$.ebsVolumeDetails.skippedVolumeDetails")	
resource_ebsVolumeDetails_skippedVolumeDetails_deviceName	json_extract(resource, "$.ebsVolumeDetails.skippedVolumeDetails.deviceName")	
resource_ebsVolumeDetails_skippedVolumeDetails_encryptionType	json_extract(resource, "$.ebsVolumeDetails.skippedVolumeDetails.encryptionType")	
resource_ebsVolumeDetails_skippedVolumeDetails_kmsKeyArn	json_extract(resource, "$.ebsVolumeDetails.skippedVolumeDetails.kmsKeyArn")	
resource_ebsVolumeDetails_skippedVolumeDetails_snapshotArn	json_extract(resource, "$.ebsVolumeDetails.skippedVolumeDetails.snapshotArn")	
resource_ebsVolumeDetails_skippedVolumeDetails_volumeArn	json_extract(resource, "$.ebsVolumeDetails.skippedVolumeDetails.volumeArn")	
resource_ebsVolumeDetails_skippedVolumeDetails_volumeSizeInGB	json_extract(resource, "$.ebsVolumeDetails.skippedVolumeDetails.volumeSizeInGB")	
resource_ebsVolumeDetails_skippedVolumeDetails_volumeType	json_extract(resource, "$.ebsVolumeDetails.skippedVolumeDetails.volumeType")	
resource_ecsClusterDetails_activeServicesCount	json_extract(resource, "$.ecsClusterDetails.activeServicesCount")	
resource_ecsClusterDetails_arn	json_extract(resource, "$.ecsClusterDetails.arn")	
resource_ecsClusterDetails_name	json_extract(resource, "$.ecsClusterDetails.name")	
resource_ecsClusterDetails_registeredContainerInstancesCount	json_extract(resource, "$.ecsClusterDetails.registeredContainerInstancesCount")	
resource_ecsClusterDetails_runningTasksCount	json_extract(resource, "$.ecsClusterDetails.runningTasksCount")	
resource_ecsClusterDetails_status	json_extract(resource, "$.ecsClusterDetails.status")	
resource_ecsClusterDetails_tags_key	json_extract(resource, "$.ecsClusterDetails.tags.key")	
resource_ecsClusterDetails_tags_value	json_extract(resource, "$.ecsClusterDetails.tags.value")	
resource_ecsClusterDetails_taskDetails_arn	json_extract(resource, "$.ecsClusterDetails.taskDetails.arn")	
resource_ecsClusterDetails_taskDetails_containers_containerRuntime	json_extract(resource, "$.ecsClusterDetails.taskDetails.containers.containerRuntime")	
resource_ecsClusterDetails_taskDetails_containers_id	json_extract(resource, "$.ecsClusterDetails.taskDetails.containers.id")	
resource_ecsClusterDetails_taskDetails_containers_image	json_extract(resource, "$.ecsClusterDetails.taskDetails.containers.image")	
resource_ecsClusterDetails_taskDetails_containers_imagePrefix	json_extract(resource, "$.ecsClusterDetails.taskDetails.containers.imagePrefix")	
resource_ecsClusterDetails_taskDetails_containers_imageUid	json_extract(resource, "$.ecsClusterDetails.taskDetails.containers.imageUid")	
resource_ecsClusterDetails_taskDetails_containers_name	json_extract(resource, "$.ecsClusterDetails.taskDetails.containers.name")	
resource_ecsClusterDetails_taskDetails_containers_securityContext_privileged	json_extract(resource, "$.ecsClusterDetails.taskDetails.containers.securityContext.privileged")	
resource_ecsClusterDetails_taskDetails_containers_volumeMounts_mountPath	json_extract(resource, "$.ecsClusterDetails.taskDetails.containers.volumeMounts.mountPath")	
resource_ecsClusterDetails_taskDetails_containers_volumeMounts_name	json_extract(resource, "$.ecsClusterDetails.taskDetails.containers.volumeMounts.name")	
resource_ecsClusterDetails_taskDetails_createdAt	json_extract(resource, "$.ecsClusterDetails.taskDetails.createdAt")	
resource_ecsClusterDetails_taskDetails_definitionArn	json_extract(resource, "$.ecsClusterDetails.taskDetails.definitionArn")	
resource_ecsClusterDetails_taskDetails_group	json_extract(resource, "$.ecsClusterDetails.taskDetails.group")	
resource_ecsClusterDetails_taskDetails_launchType	json_extract(resource, "$.ecsClusterDetails.taskDetails.launchType")	
resource_ecsClusterDetails_taskDetails_startedAt	json_extract(resource, "$.ecsClusterDetails.taskDetails.startedAt")	
resource_ecsClusterDetails_taskDetails_startedBy	json_extract(resource, "$.ecsClusterDetails.taskDetails.startedBy")	
resource_ecsClusterDetails_taskDetails_version	json_extract(resource, "$.ecsClusterDetails.taskDetails.version")	
resource_ecsClusterDetails_taskDetails_volumes_hostPath_path	json_extract(resource, "$.ecsClusterDetails.taskDetails.volumes.hostPath.path")	
resource_ecsClusterDetails_taskDetails_volumes_name	json_extract(resource, "$.ecsClusterDetails.taskDetails.volumes.name")	
resource_eksClusterDetails_arn	json_extract(resource, "$.eksClusterDetails.arn")	
resource_eksClusterDetails_createdAt	json_extract(resource, "$.eksClusterDetails.createdAt")	
resource_eksClusterDetails_name	json_extract(resource, "$.eksClusterDetails.name")	
resource_eksClusterDetails_status	json_extract(resource, "$.eksClusterDetails.status")	
resource_eksClusterDetails_tags_key	json_extract(resource, "$.eksClusterDetails.tags.key")	
resource_eksClusterDetails_tags_value	json_extract(resource, "$.eksClusterDetails.tags.value")	
resource_eksClusterDetails_vpcId	json_extract(resource, "$.eksClusterDetails.vpcId")	
resource_instanceDetails_availabilityZone	json_extract(resource, "$.instanceDetails.availabilityZone")	
resource_instanceDetails_iamInstanceProfile	json_extract(resource, "$.instanceDetails.iamInstanceProfile")	
resource_instanceDetails_iamInstanceProfile_arn	json_extract(resource, "$.instanceDetails.iamInstanceProfile.arn")	
resource_instanceDetails_iamInstanceProfile_id	json_extract(resource, "$.instanceDetails.iamInstanceProfile.id")	
resource_instanceDetails_imageDescription	json_extract(resource, "$.instanceDetails.imageDescription")	
resource_instanceDetails_imageId	json_extract(resource, "$.instanceDetails.imageId")	
resource_instanceDetails_instanceId	json_extract(resource, "$.instanceDetails.instanceId")	
resource_instanceDetails_instanceState	json_extract(resource, "$.instanceDetails.instanceState")	
resource_instanceDetails_instanceType	json_extract(resource, "$.instanceDetails.instanceType")	
resource_instanceDetails_launchTime	json_extract(resource, "$.instanceDetails.launchTime")	
resource_instanceDetails_networkInterfaces_networkInterfaceId	json_extract(resource, "$.instanceDetails.networkInterfaces[0].networkInterfaceId")	
resource_instanceDetails_networkInterfaces_ownerId	json_extract(resource, "$.instanceDetails.networkInterfaces[0].ownerId")	
resource_instanceDetails_networkInterfaces_privateDnsName	json_extract(resource, "$.instanceDetails.networkInterfaces[0].privateDnsName")	
resource_instanceDetails_networkInterfaces_privateIpAddress	json_extract(resource, "$.instanceDetails.networkInterfaces[0].privateIpAddress")	
resource_instanceDetails_networkInterfaces_privateIpAddresses_privateDnsName	json_extract(resource, "$.instanceDetails.networkInterfaces[0].privateIpAddresses.privateDnsName")	
resource_instanceDetails_networkInterfaces_privateIpAddresses_privateIpAddress	json_extract(resource, "$.instanceDetails.networkInterfaces[0].privateIpAddresses.privateIpAddress")	
resource_instanceDetails_networkInterfaces_publicDnsName	json_extract(resource, "$.instanceDetails.networkInterfaces[0].publicDnsName")	
resource_instanceDetails_networkInterfaces_publicIp	json_extract(resource, "$.instanceDetails.networkInterfaces[0].publicIp")	
resource_instanceDetails_networkInterfaces_securityGroups_groupId	json_extract(resource, "$.instanceDetails.networkInterfaces[0].securityGroups.groupId")	
resource_instanceDetails_networkInterfaces_securityGroups_groupName	json_extract(resource, "$.instanceDetails.networkInterfaces[0].securityGroups.groupName")	
resource_instanceDetails_networkInterfaces_subnetId	json_extract(resource, "$.instanceDetails.networkInterfaces[0].subnetId")	
resource_instanceDetails_networkInterfaces_vpcId	json_extract(resource, "$.instanceDetails.networkInterfaces[0].vpcId")	
resource_instanceDetails_outpostArn	json_extract(resource, "$.instanceDetails.outpostArn")	
resource_instanceDetails_platform	json_extract(resource, "$.instanceDetails.platform")	
resource_instanceDetails_productCodes_productCodeId	json_extract(resource, "$.instanceDetails.productCodes.productCodeId")	
resource_instanceDetails_productCodes_productCodeType	json_extract(resource, "$.instanceDetails.productCodes.productCodeType")	
resource_instanceDetails_tags_key	arraymap(resource -> instanceDetails.tags[], json_extract_scalar("@element", "$.key"))	
resource_instanceDetails_tags_value	arraymap(resource -> instanceDetails.tags[], json_extract_scalar("@element", "$.value"))	
resource_kubernetesDetails_kubernetesUserDetails_groups	json_extract(resource, "$.kubernetesDetails.kubernetesUserDetails.groups")	
resource_kubernetesDetails_kubernetesUserDetails_impersonatedUser_groups	json_extract(resource, "$.kubernetesDetails.kubernetesUserDetails.impersonatedUser.groups")	
resource_kubernetesDetails_kubernetesUserDetails_impersonatedUser_username	json_extract(resource, "$.kubernetesDetails.kubernetesUserDetails.impersonatedUser.username")	
resource_kubernetesDetails_kubernetesUserDetails_sessionName	json_extract(resource, "$.kubernetesDetails.kubernetesUserDetails.sessionName")	
resource_kubernetesDetails_kubernetesUserDetails_uid	json_extract(resource, "$.kubernetesDetails.kubernetesUserDetails.uid")	
resource_kubernetesDetails_kubernetesUserDetails_username	json_extract(resource, "$.kubernetesDetails.kubernetesUserDetails.username")	
resource_kubernetesDetails_kubernetesWorkloadDetails	json_extract(resource, "$.kubernetesDetails.kubernetesWorkloadDetails")	
resource_kubernetesDetails_kubernetesWorkloadDetails_containers_image	json_extract(resource, "$.kubernetesDetails.kubernetesWorkloadDetails.containers.image")	
resource_kubernetesDetails_kubernetesWorkloadDetails_containers_imagePrefix	json_extract(resource, "$.kubernetesDetails.kubernetesWorkloadDetails.containers.imagePrefix")	
resource_kubernetesDetails_kubernetesWorkloadDetails_containers_name	json_extract(resource, "$.kubernetesDetails.kubernetesWorkloadDetails.containers.name")	
resource_kubernetesDetails_kubernetesWorkloadDetails_containers_securityContext_privileged	json_extract(resource, "$.kubernetesDetails.kubernetesWorkloadDetails.containers.securityContext.privileged")	
resource_kubernetesDetails_kubernetesWorkloadDetails_containers_volumeMounts_mountPath	json_extract(resource, "$.kubernetesDetails.kubernetesWorkloadDetails.containers.volumeMounts.mountPath")	
resource_kubernetesDetails_kubernetesWorkloadDetails_containers_volumeMounts_name	json_extract(resource, "$.kubernetesDetails.kubernetesWorkloadDetails.containers.volumeMounts.name")	
resource_kubernetesDetails_kubernetesWorkloadDetails_creationTimestamp	json_extract(resource, "$.kubernetesDetails.kubernetesWorkloadDetails.creationTimestamp")	
resource_kubernetesDetails_kubernetesWorkloadDetails_hostIPC	json_extract(resource, "$.kubernetesDetails.kubernetesWorkloadDetails.hostIPC")	
resource_kubernetesDetails_kubernetesWorkloadDetails_hostNetwork	json_extract(resource, "$.kubernetesDetails.kubernetesWorkloadDetails.hostNetwork")	
resource_kubernetesDetails_kubernetesWorkloadDetails_hostPID	json_extract(resource, "$.kubernetesDetails.kubernetesWorkloadDetails.hostPID")	
resource_kubernetesDetails_kubernetesWorkloadDetails_labels	json_extract(resource, "$.kubernetesDetails.kubernetesWorkloadDetails.labels")	
resource_kubernetesDetails_kubernetesWorkloadDetails_name	json_extract(resource, "$.kubernetesDetails.kubernetesWorkloadDetails.name")	
resource_kubernetesDetails_kubernetesWorkloadDetails_namespace	json_extract(resource, "$.kubernetesDetails.kubernetesWorkloadDetails.namespace")	
resource_kubernetesDetails_kubernetesWorkloadDetails_podSecurityContext	json_extract(resource, "$.kubernetesDetails.kubernetesWorkloadDetails.podSecurityContext")	
resource_kubernetesDetails_kubernetesWorkloadDetails_selector	json_extract(resource, "$.kubernetesDetails.kubernetesWorkloadDetails.selector")	
resource_kubernetesDetails_kubernetesWorkloadDetails_serviceAccountName	json_extract(resource, "$.kubernetesDetails.kubernetesWorkloadDetails.serviceAccountName")	
resource_kubernetesDetails_kubernetesWorkloadDetails_type	json_extract(resource, "$.kubernetesDetails.kubernetesWorkloadDetails.type")	
resource_kubernetesDetails_kubernetesWorkloadDetails_uid	json_extract(resource, "$.kubernetesDetails.kubernetesWorkloadDetails.uid")	
resource_kubernetesDetails_kubernetesWorkloadDetails_volumes_hostPath_path	json_extract(resource, "$.kubernetesDetails.kubernetesWorkloadDetails.volumes.hostPath.path")	
resource_kubernetesDetails_kubernetesWorkloadDetails_volumes_name	json_extract(resource, "$.kubernetesDetails.kubernetesWorkloadDetails.volumes.name")	
resource_lambdaDetails_description	json_extract(resource, "$.lambdaDetails.description")	
resource_lambdaDetails_functionArn	json_extract(resource, "$.lambdaDetails.functionArn")	
resource_lambdaDetails_functionName	json_extract(resource, "$.lambdaDetails.functionName")	
resource_lambdaDetails_functionVersion	json_extract(resource, "$.lambdaDetails.functionVersion")	
resource_lambdaDetails_lastModifiedAt	json_extract(resource, "$.lambdaDetails.lastModifiedAt")	
resource_lambdaDetails_revisionId	json_extract(resource, "$.lambdaDetails.revisionId")	
resource_lambdaDetails_role	json_extract(resource, "$.lambdaDetails.role")	
resource_lambdaDetails_tags_key	json_extract(resource, "$.lambdaDetails.tags.key")	
resource_lambdaDetails_tags_value	json_extract(resource, "$.lambdaDetails.tags.value")	
resource_lambdaDetails_vpcConfig_securityGroups_groupId	json_extract(resource, "$.lambdaDetails.vpcConfig.securityGroups.groupId")	
resource_lambdaDetails_vpcConfig_securityGroups_groupName	json_extract(resource, "$.lambdaDetails.vpcConfig.securityGroups.groupName")	
resource_lambdaDetails_vpcConfig_subnetIds	json_extract(resource, "$.lambdaDetails.vpcConfig.subnetIds")	
resource_lambdaDetails_vpcConfig_vpcId	json_extract(resource, "$.lambdaDetails.vpcConfig.vpcId")	
resource_rdsDbInstanceDetails_dbClusterIdentifier	json_extract(resource, "$.rdsDbInstanceDetails.dbClusterIdentifier")	
resource_rdsDbInstanceDetails_dbInstanceArn	json_extract(resource, "$.rdsDbInstanceDetails.dbInstanceArn")	
resource_rdsDbInstanceDetails_dbInstanceIdentifier	json_extract(resource, "$.rdsDbInstanceDetails.dbInstanceIdentifier")	
resource_rdsDbInstanceDetails_engine	json_extract(resource, "$.rdsDbInstanceDetails.engine")	
resource_rdsDbInstanceDetails_engineVersion	json_extract(resource, "$.rdsDbInstanceDetails.engineVersion")	
resource_rdsDbInstanceDetails_tags_key	json_extract(resource, "$.rdsDbInstanceDetails.tags.key")	
resource_rdsDbInstanceDetails_tags_value	json_extract(resource, "$.rdsDbInstanceDetails.tags.value")	
resource_rdsDbUserDetails_application	json_extract(resource, "$.rdsDbUserDetails.application")	
resource_rdsDbUserDetails_authMethod	json_extract(resource, "$.rdsDbUserDetails.authMethod")	
resource_rdsDbUserDetails_database	json_extract(resource, "$.rdsDbUserDetails.database")	
resource_rdsDbUserDetails_ssl	json_extract(resource, "$.rdsDbUserDetails.ssl")	
resource_rdsDbUserDetails_user	json_extract(resource, "$.rdsDbUserDetails.user")	
resource_resourceType	json_extract(resource, "$.$Type")	
resource_s3BucketDetails_arn	json_extract(resource, "$.s3BucketDetails[0].arn")	
resource_s3BucketDetails_createdAt	json_extract(resource, "$.s3BucketDetails[0].createdAt")	
resource_s3BucketDetails_defaultServerSideEncryption	json_extract(resource, "$.s3BucketDetails[0].defaultServerSideEncryption")	
resource_s3BucketDetails_defaultServerSideEncryption_encryptionType	json_extract(resource, "$.s3BucketDetails[0].defaultServerSideEncryption.encryptionType")	
resource_s3BucketDetails_defaultServerSideEncryption_kmsMasterKeyArn	json_extract(resource, "$.s3BucketDetails[0].defaultServerSideEncryption.kmsMasterKeyArn")	
resource_s3BucketDetails_name	json_extract(resource, "$.s3BucketDetails[0].name")	
resource_s3BucketDetails_owner_id	json_extract(resource, "$.s3BucketDetails[0].owner.id")	
resource_s3BucketDetails_publicAccess_effectivePermission	json_extract_scalar(resource, "$.s3BucketDetails[0].publicAccess.effectivePermission")	
resource_s3BucketDetails_publicAccess_permissionConfiguration_accountLevelPermissions_blockPublicAccess_blockPublicAcls	json_extract(resource, "$.s3BucketDetails[0].publicAccess.permissionConfiguration.accountLevelPermissions.blockPublicAccess.blockPublicAcls")	
resource_s3BucketDetails_publicAccess_permissionConfiguration_accountLevelPermissions_blockPublicAccess_blockPublicPolicy	json_extract(resource, "$.s3BucketDetails[0].publicAccess.permissionConfiguration.accountLevelPermissions.blockPublicAccess.blockPublicPolicy")	
resource_s3BucketDetails_publicAccess_permissionConfiguration_accountLevelPermissions_blockPublicAccess_ignorePublicAcls	json_extract(resource, "$.s3BucketDetails[0].publicAccess.permissionConfiguration.accountLevelPermissions.blockPublicAccess.ignorePublicAcls")	
resource_s3BucketDetails_publicAccess_permissionConfiguration_accountLevelPermissions_blockPublicAccess_restrictPublicBuckets	json_extract(resource, "$.s3BucketDetails[0].publicAccess.permissionConfiguration.accountLevelPermissions.blockPublicAccess.restrictPublicBuckets")	
resource_s3BucketDetails_publicAccess_permissionConfiguration_bucketLevelPermissions_accessControlList	json_extract(resource, "$.s3BucketDetails[0].publicAccess.permissionConfiguration.bucketLevelPermissions.accessControlList")	
resource_s3BucketDetails_publicAccess_permissionConfiguration_bucketLevelPermissions_accessControlList_allowsPublicfcloudtraReadAccess	json_extract(resource, "$.s3BucketDetails[0].publicAccess.permissionConfiguration.bucketLevelPermissions.accessControlList.allowsPublicReadAccess")	
resource_s3BucketDetails_publicAccess_permissionConfiguration_bucketLevelPermissions_accessControlList_allowsPublicWriteAccess	json_extract(resource, "$.s3BucketDetails[0].publicAccess.permissionConfiguration.bucketLevelPermissions.accessControlList.allowsPublicWriteAccess")	
resource_s3BucketDetails_publicAccess_permissionConfiguration_bucketLevelPermissions_blockPublicAccess	json_extract(resource, "$.s3BucketDetails[0].publicAccess.permissionConfiguration.bucketLevelPermissions.blockPublicAccess")	
resource_s3BucketDetails_publicAccess_permissionConfiguration_bucketLevelPermissions_blockPublicAccess_blockPublicAcls	json_extract(resource, "$.s3BucketDetails[0].publicAccess.permissionConfiguration.bucketLevelPermissions.blockPublicAccess.blockPublicAcls")	
resource_s3BucketDetails_publicAccess_permissionConfiguration_bucketLevelPermissions_blockPublicAccess_blockPublicPolicy	json_extract(resource, "$.s3BucketDetails[0].publicAccess.permissionConfiguration.bucketLevelPermissions.blockPublicAccess.blockPublicPolicy")	
resource_s3BucketDetails_publicAccess_permissionConfiguration_bucketLevelPermissions_blockPublicAccess_ignorePublicAcls	json_extract(resource, "$.s3BucketDetails[0].publicAccess.permissionConfiguration.bucketLevelPermissions.blockPublicAccess.ignorePublicAcls")	
resource_s3BucketDetails_publicAccess_permissionConfiguration_bucketLevelPermissions_blockPublicAccess_restrictPublicBuckets	json_extract(resource, "$.s3BucketDetails[0].publicAccess.permissionConfiguration.bucketLevelPermissions.blockPublicAccess.restrictPublicBuckets")	
resource_s3BucketDetails_publicAccess_permissionConfiguration_bucketLevelPermissions_bucketPolicy	json_extract(resource, "$.s3BucketDetails[0].publicAccess.permissionConfiguration.bucketLevelPermissions.bucketPolicy")	
resource_s3BucketDetails_publicAccess_permissionConfiguration_bucketLevelPermissions_bucketPolicy_allowsPublicReadAccess	json_extract(resource, "$.s3BucketDetails[0].publicAccess.permissionConfiguration.bucketLevelPermissions.bucketPolicy.allowsPublicReadAccess")	
resource_s3BucketDetails_publicAccess_permissionConfiguration_bucketLevelPermissions_bucketPolicy_allowsPublicWriteAccess	json_extract(resource, "$.s3BucketDetails[0].publicAccess.permissionConfiguration.bucketLevelPermissions.bucketPolicy.allowsPublicWriteAccess")	
resource_s3BucketDetails_tags	json_extract(resource, "$.s3BucketDetails[0].tags")	
resource_s3BucketDetails_tags_key	json_extract(resource, "$.s3BucketDetails[0].tags.key")	
resource_s3BucketDetails_tags_value	json_extract(resource, "$.s3BucketDetails[0].tags.value")	
resource_s3BucketDetails_type	json_extract(resource, "$.s3BucketDetails[0].type")	
resource_s3BucketDetails_objectdetails_etag	json_extract_scalar(resource, "$.s3BucketDetails[0].s3ObjectDetails[0].eTag"), resource_s3BucketDetails_objectdetails_hash = json_extract_scalar(resource, "$.s3BucketDetails[0].s3ObjectDetails[0].hash"), resource_s3BucketDetails_objectdetails_key = json_extract_scalar(resource, "$.s3BucketDetails[0].s3ObjectDetails[0].key"), resource_s3BucketDetails_objectdetails_objectArn = json_extract_scalar(resource, "$.s3BucketDetails[0].s3ObjectDetails[0].objectArn"), resource_s3BucketDetails_objectdetails_versionId = json_extract_scalar(resource, "$.s3BucketDetails[0].s3ObjectDetails[0].versionId")	
service_action_actionType	json_extract(service, "$.action.actionType")	
service_action_awsApiCallAction_affectedResources_AWS__CloudTrail__Trail	replace(json_extract(service, "$.action.awsApiCallAction.affectedResources.AWS::EC2::Instance"), "\"", "")	
service_action_awsApiCallAction_affectedResources_AWS__EC2__Instance	replace(json_extract(service, "$.action.awsApiCallAction.affectedResources.AWS::EC2::Instance"), "\"", "")	
service_action_awsApiCallAction_affectedResources_AWS__S3__Bucket	replace(json_extract(service, "$.action.awsApiCallAction.affectedResources.AWS::S3::Bucket"), "\"", "")	
service_action_awsApiCallAction_api	json_extract(service, "$.action.awsApiCallAction.api")	
service_action_awsApiCallAction_callerType	json_extract(service, "$.action.awsApiCallAction.callerType")	
service_action_awsApiCallAction_domainDetails_domain	json_extract(service, "$.action.awsApiCallAction.domainDetails.domain")	
service_action_awsApiCallAction_errorCode	json_extract(service, "$.action.awsApiCallAction.errorCode")	
service_action_awsApiCallAction_remoteAccountDetails_accountId	json_extract(service, "$.action.awsApiCallAction.remoteAccountDetails.accountId")	
service_action_awsApiCallAction_remoteAccountDetails_affiliated	json_extract(service, "$.action.awsApiCallAction.remoteAccountDetails.affiliated")	
service_action_awsApiCallAction_remoteIpDetails_city_cityName	json_extract(service, "$.action.awsApiCallAction.remoteIpDetails.city.cityName")	
service_action_awsApiCallAction_remoteIpDetails_country_countryName	json_extract(service, "$.action.awsApiCallAction.remoteIpDetails.country.countryName")	
service_action_awsApiCallAction_remoteIpDetails_geoLocation_lat	json_extract(service, "$.action.awsApiCallAction.remoteIpDetails.geoLocation.lat")	
service_action_awsApiCallAction_remoteIpDetails_geoLocation_lon	json_extract(service, "$.action.awsApiCallAction.remoteIpDetails.geoLocation.lon")	
service_action_awsApiCallAction_remoteIpDetails_ipAddressV4	json_extract(service, "$.action.awsApiCallAction.remoteIpDetails.ipAddressV4")	
service_action_awsApiCallAction_remoteIpDetails_ipAddressV6	json_extract(service, "$.action.awsApiCallAction.remoteIpDetails.ipAddressV6")	
service_action_awsApiCallAction_remoteIpDetails_organization_asn	json_extract(service, "$.action.awsApiCallAction.remoteIpDetails.organization.asn")	
service_action_awsApiCallAction_remoteIpDetails_organization_asnOrg	json_extract(service, "$.action.awsApiCallAction.remoteIpDetails.organization.asnOrg")	
service_action_awsApiCallAction_remoteIpDetails_organization_isp	json_extract(service, "$.action.awsApiCallAction.remoteIpDetails.organization.isp")	
service_action_awsApiCallAction_remoteIpDetails_organization_org	json_extract(service, "$.action.awsApiCallAction.remoteIpDetails.organization.org")	
service_action_awsApiCallAction_serviceName	json_extract(service, "$.action.awsApiCallAction.$Name")	
service_action_dnsRequestAction_blocked	json_extract(service, "$.action.dnsRequestAction.blocked")	
service_action_dnsRequestAction_domain	json_extract(service, "$.action.dnsRequestAction.domain")	
service_action_dnsRequestAction_domainWithSuffix	json_extract(service, "$.action.dnsRequestAction.domainWithSuffix")	
service_action_dnsRequestAction_protocol	json_extract(service, "$.action.dnsRequestAction.protocol")	
service_action_kubernetesApiCallAction_namespace	json_extract(service, "$.action.kubernetesApiCallAction.namespace")	
service_action_kubernetesApiCallAction_parameters	json_extract(service, "$.action.kubernetesApiCallAction.parameters")	
service_action_kubernetesApiCallAction_remoteIpDetails_city_cityName	json_extract(service, "$.action.kubernetesApiCallAction.remoteIpDetails.city.cityName")	
service_action_kubernetesApiCallAction_remoteIpDetails_country_countryName	json_extract(service, "$.action.kubernetesApiCallAction.remoteIpDetails.country.countryName")	
service_action_kubernetesApiCallAction_remoteIpDetails_geoLocation_lat	json_extract(service, "$.action.kubernetesApiCallAction.remoteIpDetails.geoLocation.lat")	
service_action_kubernetesApiCallAction_remoteIpDetails_geoLocation_lon	json_extract(service, "$.action.kubernetesApiCallAction.remoteIpDetails.geoLocation.lon")	
service_action_kubernetesApiCallAction_remoteIpDetails_ipAddressV4	json_extract(service, "$.action.kubernetesApiCallAction.remoteIpDetails.ipAddressV4")	
service_action_kubernetesApiCallAction_remoteIpDetails_ipAddressV6	json_extract(service, "$.action.kubernetesApiCallAction.remoteIpDetails.ipAddressV6")	
service_action_kubernetesApiCallAction_remoteIpDetails_organization_asn	json_extract(service, "$.action.kubernetesApiCallAction.remoteIpDetails.organization.asn")	
service_action_kubernetesApiCallAction_remoteIpDetails_organization_asnOrg	json_extract(service, "$.action.kubernetesApiCallAction.remoteIpDetails.organization.asnOrg")	
service_action_kubernetesApiCallAction_remoteIpDetails_organization_isp	json_extract(service, "$.action.kubernetesApiCallAction.remoteIpDetails.organization.isp")	
service_action_kubernetesApiCallAction_remoteIpDetails_organization_org	json_extract(service, "$.action.kubernetesApiCallAction.remoteIpDetails.organization.org")	
service_action_kubernetesApiCallAction_requestUri	json_extract(service, "$.action.kubernetesApiCallAction.requestUri")	
service_action_kubernetesApiCallAction_resource	json_extract(service, "$.action.kubernetesApiCallAction.resource")	
service_action_kubernetesApiCallAction_resourceName	json_extract(service, "$.action.kubernetesApiCallAction.resourceName")	
service_action_kubernetesApiCallAction_sourceIPs	json_extract(service, "$.action.kubernetesApiCallAction.sourceIPs")	
service_action_kubernetesApiCallAction_statusCode	json_extract(service, "$.action.kubernetesApiCallAction.statusCode")	
service_action_kubernetesApiCallAction_subresource	json_extract(service, "$.action.kubernetesApiCallAction.subresource")	
service_action_kubernetesApiCallAction_userAgent	json_extract(service, "$.action.kubernetesApiCallAction.userAgent")	
service_action_kubernetesApiCallAction_verb	json_extract(service, "$.action.kubernetesApiCallAction.verb")	
service_action_kubernetesPermissionCheckedDetails	json_extract(service, "$.action.kubernetesPermissionCheckedDetails")	
service_action_kubernetesPermissionCheckedDetails_allowed	json_extract(service, "$.action.kubernetesPermissionCheckedDetails.allowed")	
service_action_kubernetesPermissionCheckedDetails_namespace	json_extract(service, "$.action.kubernetesPermissionCheckedDetails.namespace")	
service_action_kubernetesPermissionCheckedDetails_resource	json_extract(service, "$.action.kubernetesPermissionCheckedDetails.resource")	
service_action_kubernetesPermissionCheckedDetails_verb	json_extract(service, "$.action.kubernetesPermissionCheckedDetails.verb")	
service_action_kubernetesRoleBindingDetails	json_extract(service, "$.action.kubernetesRoleBindingDetails")	
service_action_kubernetesRoleBindingDetails_kind	json_extract(service, "$.action.kubernetesRoleBindingDetails.kind")	
service_action_kubernetesRoleBindingDetails_name	json_extract(service, "$.action.kubernetesRoleBindingDetails.name")	
service_action_kubernetesRoleBindingDetails_roleRefKind	json_extract(service, "$.action.kubernetesRoleBindingDetails.roleRefKind")	
service_action_kubernetesRoleBindingDetails_roleRefName	json_extract(service, "$.action.kubernetesRoleBindingDetails.roleRefName")	
service_action_kubernetesRoleBindingDetails_uid	json_extract(service, "$.action.kubernetesRoleBindingDetails.uid")	
service_action_kubernetesRoleDetails	json_extract(service, "$.action.kubernetesRoleDetails")	
service_action_kubernetesRoleDetails_kind	json_extract(service, "$.action.kubernetesRoleDetails.kind")	
service_action_kubernetesRoleDetails_name	json_extract(service, "$.action.kubernetesRoleDetails.name")	
service_action_kubernetesRoleDetails_uid	json_extract(service, "$.action.kubernetesRoleDetails.uid")	
service_action_networkConnectionAction_blocked	json_extract(service, "$.action.networkConnectionAction.blocked")	
service_action_networkConnectionAction_connectionDirection	json_extract(service, "$.action.networkConnectionAction.connectionDirection")	
service_action_networkConnectionAction_localIpDetails_ipAddressV4	json_extract(service, "$.action.networkConnectionAction.localIpDetails.ipAddressV4")	
service_action_networkConnectionAction_localIpDetails_ipAddressV6	json_extract(service, "$.action.networkConnectionAction.localIpDetails.ipAddressV6")	
service_action_networkConnectionAction_localPortDetails_port	json_extract(service, "$.action.networkConnectionAction.localPortDetails.port")	
service_action_networkConnectionAction_localPortDetails_portName	json_extract(service, "$.action.networkConnectionAction.localPortDetails.portName")	
service_action_networkConnectionAction_protocol	json_extract(service, "$.action.networkConnectionAction.protocol")	
service_action_networkConnectionAction_remoteIpDetails_city_cityName	json_extract(service, "$.action.networkConnectionAction.remoteIpDetails.city.cityName")	
service_action_networkConnectionAction_remoteIpDetails_country_countryName	json_extract(service, "$.action.networkConnectionAction.remoteIpDetails.country.countryName")	
service_action_networkConnectionAction_remoteIpDetails_geoLocation_lat	json_extract(service, "$.action.networkConnectionAction.remoteIpDetails.geoLocation.lat")	
service_action_networkConnectionAction_remoteIpDetails_geoLocation_lon	json_extract(service, "$.action.networkConnectionAction.remoteIpDetails.geoLocation.lon")	
service_action_networkConnectionAction_remoteIpDetails_ipAddressV4	json_extract(service, "$.action.networkConnectionAction.remoteIpDetails.ipAddressV4")	
service_action_networkConnectionAction_remoteIpDetails_ipAddressV6	json_extract(service, "$.action.networkConnectionAction.remoteIpDetails.ipAddressV6")	
service_action_networkConnectionAction_remoteIpDetails_organization_asn	json_extract(service, "$.action.networkConnectionAction.remoteIpDetails.organization.asn")	
service_action_networkConnectionAction_remoteIpDetails_organization_asnOrg	json_extract(service, "$.action.networkConnectionAction.remoteIpDetails.organization.asnOrg")	
service_action_networkConnectionAction_remoteIpDetails_organization_isp	json_extract(service, "$.action.networkConnectionAction.remoteIpDetails.organization.isp")	
service_action_networkConnectionAction_remoteIpDetails_organization_org	json_extract(service, "$.action.networkConnectionAction.remoteIpDetails.organization.org")	
service_action_networkConnectionAction_remotePortDetails_port	json_extract(service, "$.action.networkConnectionAction.remotePortDetails.port")	
service_action_networkConnectionAction_remotePortDetails_portName	json_extract(service, "$.action.networkConnectionAction.remotePortDetails.portName")	
service_action_portProbeAction_blocked	json_extract(service, "$.action.portProbeAction.blocked")	
service_action_portProbeAction_portProbeDetails_localIpDetails_ipAddressV4	json_extract(service, "$.action.portProbeAction.portProbeDetails[0].localIpDetails.ipAddressV4")	
service_action_portProbeAction_portProbeDetails_localPortDetails_port	json_extract(service, "$.action.portProbeAction.portProbeDetails[0].localPortDetails.port")	
service_action_portProbeAction_portProbeDetails_localPortDetails_portName	json_extract(service, "$.action.portProbeAction.portProbeDetails[0].localPortDetails.portName")	
service_action_portProbeAction_portProbeDetails_remoteIpDetails_city_cityName	json_extract(service, "$.action.portProbeAction.portProbeDetails[0].remoteIpDetails.city.cityName")	
service_action_portProbeAction_portProbeDetails_remoteIpDetails_country_countryName	json_extract(service, "$.action.portProbeAction.portProbeDetails[0].remoteIpDetails.country.countryName")	
service_action_portProbeAction_portProbeDetails_remoteIpDetails_geoLocation_lat	json_extract(service, "$.action.portProbeAction.portProbeDetails[0].remoteIpDetails.geoLocation.lat")	
service_action_portProbeAction_portProbeDetails_remoteIpDetails_geoLocation_lon	json_extract(service, "$.action.portProbeAction.portProbeDetails[0].remoteIpDetails.geoLocation.lon")	
service_action_portProbeAction_portProbeDetails_remoteIpDetails_ipAddressV4	json_extract(service, "$.action.portProbeAction.portProbeDetails[0].remoteIpDetails.ipAddressV4")	
service_action_portProbeAction_portProbeDetails_remoteIpDetails_ipAddressV6	json_extract(service, "$.action.portProbeAction.portProbeDetails[0].remoteIpDetails.ipAddressV6")	
service_action_portProbeAction_portProbeDetails_remoteIpDetails_organization_asn	json_extract(service, "$.action.portProbeAction.portProbeDetails[0].remoteIpDetails.organization.asn")	
service_action_portProbeAction_portProbeDetails_remoteIpDetails_organization_asnOrg	json_extract(service, "$.action.portProbeAction.portProbeDetails[0].remoteIpDetails.organization.asnOrg")	
service_action_portProbeAction_portProbeDetails_remoteIpDetails_organization_isp	json_extract(service, "$.action.portProbeAction.portProbeDetails[0].remoteIpDetails.organization.isp")	
service_action_portProbeAction_portProbeDetails_remoteIpDetails_organization_org	json_extract(service, "$.action.portProbeAction.portProbeDetails[0].remoteIpDetails.organization.org")	
service_action_rdsLoginAttemptAction_remoteIpDetails_city_cityName	json_extract(service, "$.action.rdsLoginAttemptAction.remoteIpDetails.city.cityName")	
service_action_rdsLoginAttemptAction_remoteIpDetails_country_countryName	json_extract(service, "$.action.rdsLoginAttemptAction.remoteIpDetails.country.countryName")	
service_action_rdsLoginAttemptAction_remoteIpDetails_geoLocation_lat	json_extract(service, "$.action.rdsLoginAttemptAction.remoteIpDetails.geoLocation.lat")	
service_action_rdsLoginAttemptAction_remoteIpDetails_geoLocation_lon	json_extract(service, "$.action.rdsLoginAttemptAction.remoteIpDetails.geoLocation.lon")	
service_action_rdsLoginAttemptAction_remoteIpDetails_ipAddressV4	json_extract(service, "$.action.rdsLoginAttemptAction.remoteIpDetails.ipAddressV4")	
service_action_rdsLoginAttemptAction_remoteIpDetails_ipAddressV6	json_extract(service, "$.action.rdsLoginAttemptAction.remoteIpDetails.ipAddressV6")	
service_action_rdsLoginAttemptAction_remoteIpDetails_organization_asn	json_extract(service, "$.action.rdsLoginAttemptAction.remoteIpDetails.organization.asn")	
service_action_rdsLoginAttemptAction_remoteIpDetails_organization_asnOrg	json_extract(service, "$.action.rdsLoginAttemptAction.remoteIpDetails.organization.asnOrg")	
service_action_rdsLoginAttemptAction_remoteIpDetails_organization_isp	json_extract(service, "$.action.rdsLoginAttemptAction.remoteIpDetails.organization.isp")	
service_action_rdsLoginAttemptAction_remoteIpDetails_organization_org	json_extract(service, "$.action.rdsLoginAttemptAction.remoteIpDetails.organization.org")	
service_additionalInfo_agentDetails_agentId	json_extract(service, "$.additionalInfo.agentDetails.agentId")	
service_additionalInfo_agentDetails_agentVersion	json_extract(service, "$.additionalInfo.agentDetails.agentVersion")	
service_additionalInfo_anomalies_anomalousAPIs	json_extract(service, "$.additionalInfo.anomalies.anomalousAPIs")	
service_additionalInfo_apiCalls_count	json_extract(service, "$.additionalInfo.apiCalls.count")	
service_additionalInfo_apiCalls_firstSeen	json_extract(service, "$.additionalInfo.apiCalls.firstSeen")	
service_additionalInfo_apiCalls_lastSeen	json_extract(service, "$.additionalInfo.apiCalls.lastSeen")	
service_additionalInfo_apiCalls_name	json_extract(service, "$.additionalInfo.apiCalls.name")	
service_additionalInfo_authenticationMethod	json_extract(service, "$.additionalInfo.authenticationMethod")	
service_additionalInfo_context	json_extract(service, "$.additionalInfo.context")	
service_additionalInfo_domain	json_extract(service, "$.additionalInfo.domain")	
service_additionalInfo_inBytes	json_extract(service, "$.additionalInfo.inBytes")	
service_additionalInfo_localPort	json_extract(service, "$.additionalInfo.localPort")	
service_additionalInfo_newPolicy_allowUsersToChangePassword	json_extract(service, "$.additionalInfo.newPolicy.allowUsersToChangePassword")	
service_additionalInfo_newPolicy_hardExpiry	json_extract(service, "$.additionalInfo.newPolicy.hardExpiry")	
service_additionalInfo_newPolicy_maxPasswordAge	json_extract(service, "$.additionalInfo.newPolicy.maxPasswordAge")	
service_additionalInfo_newPolicy_minimumPasswordLength	json_extract(service, "$.additionalInfo.newPolicy.minimumPasswordLength")	
service_additionalInfo_newPolicy_passwordReusePrevention	json_extract(service, "$.additionalInfo.newPolicy.passwordReusePrevention")	
service_additionalInfo_newPolicy_requireLowercaseCharacters	json_extract(service, "$.additionalInfo.newPolicy.requireLowercaseCharacters")	
service_additionalInfo_newPolicy_requireNumbers	json_extract(service, "$.additionalInfo.newPolicy.requireNumbers")	
service_additionalInfo_newPolicy_requireSymbols	json_extract(service, "$.additionalInfo.newPolicy.requireSymbols")	
service_additionalInfo_newPolicy_requireUppercaseCharacters	json_extract(service, "$.additionalInfo.newPolicy.requireUppercaseCharacters")	
service_additionalInfo_oldPolicy_allowUsersToChangePassword	json_extract(service, "$.additionalInfo.oldPolicy.allowUsersToChangePassword")	
service_additionalInfo_oldPolicy_hardExpiry	json_extract(service, "$.additionalInfo.oldPolicy.hardExpiry")	
service_additionalInfo_oldPolicy_maxPasswordAge	json_extract(service, "$.additionalInfo.oldPolicy.maxPasswordAge")	
service_additionalInfo_oldPolicy_minimumPasswordLength	json_extract(service, "$.additionalInfo.oldPolicy.minimumPasswordLength")	
service_additionalInfo_oldPolicy_passwordReusePrevention	json_extract(service, "$.additionalInfo.oldPolicy.passwordReusePrevention")	
service_additionalInfo_oldPolicy_requireLowercaseCharacters	json_extract(service, "$.additionalInfo.oldPolicy.requireLowercaseCharacters")	
service_additionalInfo_oldPolicy_requireNumbers	json_extract(service, "$.additionalInfo.oldPolicy.requireNumbers")	
service_additionalInfo_oldPolicy_requireSymbols	json_extract(service, "$.additionalInfo.oldPolicy.requireSymbols")	
service_additionalInfo_oldPolicy_requireUppercaseCharacters	json_extract(service, "$.additionalInfo.oldPolicy.requireUppercaseCharacters")	
service_additionalInfo_outBytes	json_extract(service, "$.additionalInfo.outBytes")	
service_additionalInfo_portsScannedSample	json_extract(service, "$.additionalInfo.portsScannedSample")	
service_additionalInfo_profiledBehavior_frequentProfiledAPIsAccountProfiling	json_extract(service, "$.additionalInfo.profiledBehavior.frequentProfiledAPIsAccountProfiling")	
service_additionalInfo_profiledBehavior_frequentProfiledAPIsUserIdentityProfiling	json_extract(service, "$.additionalInfo.profiledBehavior.frequentProfiledAPIsUserIdentityProfiling")	
service_additionalInfo_profiledBehavior_frequentProfiledASNsAccountProfiling	json_extract(service, "$.additionalInfo.profiledBehavior.frequentProfiledASNsAccountProfiling")	
service_additionalInfo_profiledBehavior_frequentProfiledASNsBucketProfiling	json_extract(service, "$.additionalInfo.profiledBehavior.frequentProfiledASNsBucketProfiling")	
service_additionalInfo_profiledBehavior_frequentProfiledASNsUserIdentityProfiling	json_extract(service, "$.additionalInfo.profiledBehavior.frequentProfiledASNsUserIdentityProfiling")	
service_additionalInfo_profiledBehavior_frequentProfiledBucketsAccountProfiling	json_extract(service, "$.additionalInfo.profiledBehavior.frequentProfiledBucketsAccountProfiling")	
service_additionalInfo_profiledBehavior_frequentProfiledBucketsUserIdentityProfiling	json_extract(service, "$.additionalInfo.profiledBehavior.frequentProfiledBucketsUserIdentityProfiling")	
service_additionalInfo_profiledBehavior_frequentProfiledUserAgentsAccountProfiling	json_extract(service, "$.additionalInfo.profiledBehavior.frequentProfiledUserAgentsAccountProfiling")	
service_additionalInfo_profiledBehavior_frequentProfiledUserAgentsUserIdentityProfiling	json_extract(service, "$.additionalInfo.profiledBehavior.frequentProfiledUserAgentsUserIdentityProfiling")	
service_additionalInfo_profiledBehavior_frequentProfiledUserNamesAccountProfiling	json_extract(service, "$.additionalInfo.profiledBehavior.frequentProfiledUserNamesAccountProfiling")	
service_additionalInfo_profiledBehavior_frequentProfiledUserNamesBucketProfiling	json_extract(service, "$.additionalInfo.profiledBehavior.frequentProfiledUserNamesBucketProfiling")	
service_additionalInfo_profiledBehavior_frequentProfiledUserTypesAccountProfiling	json_extract(service, "$.additionalInfo.profiledBehavior.frequentProfiledUserTypesAccountProfiling")	
service_additionalInfo_profiledBehavior_infrequentProfiledAPIsAccountProfiling	json_extract(service, "$.additionalInfo.profiledBehavior.infrequentProfiledAPIsAccountProfiling")	
service_additionalInfo_profiledBehavior_infrequentProfiledAPIsUserIdentityProfiling	json_extract(service, "$.additionalInfo.profiledBehavior.infrequentProfiledAPIsUserIdentityProfiling")	
service_additionalInfo_profiledBehavior_infrequentProfiledASNsAccountProfiling	json_extract(service, "$.additionalInfo.profiledBehavior.infrequentProfiledASNsAccountProfiling")	
service_additionalInfo_profiledBehavior_infrequentProfiledASNsBucketProfiling	json_extract(service, "$.additionalInfo.profiledBehavior.infrequentProfiledASNsBucketProfiling")	
service_additionalInfo_profiledBehavior_infrequentProfiledASNsUserIdentityProfiling	json_extract(service, "$.additionalInfo.profiledBehavior.infrequentProfiledASNsUserIdentityProfiling")	
service_additionalInfo_profiledBehavior_infrequentProfiledBucketsAccountProfiling	json_extract(service, "$.additionalInfo.profiledBehavior.infrequentProfiledBucketsAccountProfiling")	
service_additionalInfo_profiledBehavior_infrequentProfiledBucketsUserIdentityProfiling	json_extract(service, "$.additionalInfo.profiledBehavior.infrequentProfiledBucketsUserIdentityProfiling")	
service_additionalInfo_profiledBehavior_infrequentProfiledUserAgentsAccountProfiling	json_extract(service, "$.additionalInfo.profiledBehavior.infrequentProfiledUserAgentsAccountProfiling")	
service_additionalInfo_profiledBehavior_infrequentProfiledUserAgentsUserIdentityProfiling	json_extract(service, "$.additionalInfo.profiledBehavior.infrequentProfiledUserAgentsUserIdentityProfiling")	
service_additionalInfo_profiledBehavior_infrequentProfiledUserNamesAccountProfiling	json_extract(service, "$.additionalInfo.profiledBehavior.infrequentProfiledUserNamesAccountProfiling")	
service_additionalInfo_profiledBehavior_infrequentProfiledUserNamesBucketProfiling	json_extract(service, "$.additionalInfo.profiledBehavior.infrequentProfiledUserNamesBucketProfiling")	
service_additionalInfo_profiledBehavior_infrequentProfiledUserTypesAccountProfiling	json_extract(service, "$.additionalInfo.profiledBehavior.infrequentProfiledUserTypesAccountProfiling")	
service_additionalInfo_profiledBehavior_numberOfHistoricalDailyAvgAPIsBucketProfiling	json_extract(service, "$.additionalInfo.profiledBehavior.numberOfHistoricalDailyAvgAPIsBucketProfiling")	
service_additionalInfo_profiledBehavior_numberOfHistoricalDailyAvgAPIsBucketUserIdentityProfiling	json_extract(service, "$.additionalInfo.profiledBehavior.numberOfHistoricalDailyAvgAPIsBucketUserIdentityProfiling")	
service_additionalInfo_profiledBehavior_numberOfHistoricalDailyAvgAPIsUserIdentityProfiling	json_extract(service, "$.additionalInfo.profiledBehavior.numberOfHistoricalDailyAvgAPIsUserIdentityProfiling")	
service_additionalInfo_profiledBehavior_numberOfHistoricalDailyMaxAPIsBucketProfiling	json_extract(service, "$.additionalInfo.profiledBehavior.numberOfHistoricalDailyMaxAPIsBucketProfiling")	
service_additionalInfo_profiledBehavior_numberOfHistoricalDailyMaxAPIsBucketUserIdentityProfiling	json_extract(service, "$.additionalInfo.profiledBehavior.numberOfHistoricalDailyMaxAPIsBucketUserIdentityProfiling")	
service_additionalInfo_profiledBehavior_numberOfHistoricalDailyMaxAPIsUserIdentityProfiling	json_extract(service, "$.additionalInfo.profiledBehavior.numberOfHistoricalDailyMaxAPIsUserIdentityProfiling")	
service_additionalInfo_profiledBehavior_profiledSuccessfulApplicationNamesClusterProfiling_applicationName	json_extract(service, "$.additionalInfo.profiledBehavior.profiledSuccessfulApplicationNamesClusterProfiling.applicationName")	
service_additionalInfo_profiledBehavior_profiledSuccessfulApplicationNamesClusterProfiling_count	json_extract(service, "$.additionalInfo.profiledBehavior.profiledSuccessfulApplicationNamesClusterProfiling.count")	
service_additionalInfo_profiledBehavior_profiledSuccessfulAsnOrgsClusterProfiling_asnOrg	json_extract(service, "$.additionalInfo.profiledBehavior.profiledSuccessfulAsnOrgsClusterProfiling.asnOrg")	
service_additionalInfo_profiledBehavior_profiledSuccessfulAsnOrgsClusterProfiling_count	json_extract(service, "$.additionalInfo.profiledBehavior.profiledSuccessfulAsnOrgsClusterProfiling.count")	
service_additionalInfo_profiledBehavior_profiledSuccessfulDatabaseNamesClusterProfiling_count	json_extract(service, "$.additionalInfo.profiledBehavior.profiledSuccessfulDatabaseNamesClusterProfiling.count")	
service_additionalInfo_profiledBehavior_profiledSuccessfulDatabaseNamesClusterProfiling_databaseName	json_extract(service, "$.additionalInfo.profiledBehavior.profiledSuccessfulDatabaseNamesClusterProfiling.databaseName")	
service_additionalInfo_profiledBehavior_profiledSuccessfulUserNamesClusterProfiling_count	json_extract(service, "$.additionalInfo.profiledBehavior.profiledSuccessfulUserNamesClusterProfiling.count")	
service_additionalInfo_profiledBehavior_profiledSuccessfulUserNamesClusterProfiling_userName	json_extract(service, "$.additionalInfo.profiledBehavior.profiledSuccessfulUserNamesClusterProfiling.userName")	
service_additionalInfo_profiledBehavior_rareProfiledAPIsAccountProfiling	json_extract(service, "$.additionalInfo.profiledBehavior.rareProfiledAPIsAccountProfiling")	
service_additionalInfo_profiledBehavior_rareProfiledAPIsUserIdentityProfiling	json_extract(service, "$.additionalInfo.profiledBehavior.rareProfiledAPIsUserIdentityProfiling")	
service_additionalInfo_profiledBehavior_rareProfiledASNsAccountProfiling	json_extract(service, "$.additionalInfo.profiledBehavior.rareProfiledASNsAccountProfiling")	
service_additionalInfo_profiledBehavior_rareProfiledASNsBucketProfiling	json_extract(service, "$.additionalInfo.profiledBehavior.rareProfiledASNsBucketProfiling")	
service_additionalInfo_profiledBehavior_rareProfiledASNsUserIdentityProfiling	json_extract(service, "$.additionalInfo.profiledBehavior.rareProfiledASNsUserIdentityProfiling")	
service_additionalInfo_profiledBehavior_rareProfiledBucketsAccountProfiling	json_extract(service, "$.additionalInfo.profiledBehavior.rareProfiledBucketsAccountProfiling")	
service_additionalInfo_profiledBehavior_rareProfiledBucketsUserIdentityProfiling	json_extract(service, "$.additionalInfo.profiledBehavior.rareProfiledBucketsUserIdentityProfiling")	
service_additionalInfo_profiledBehavior_rareProfiledUserAgentsAccountProfiling	json_extract(service, "$.additionalInfo.profiledBehavior.rareProfiledUserAgentsAccountProfiling")	
service_additionalInfo_profiledBehavior_rareProfiledUserAgentsUserIdentityProfiling	json_extract(service, "$.additionalInfo.profiledBehavior.rareProfiledUserAgentsUserIdentityProfiling")	
service_additionalInfo_profiledBehavior_rareProfiledUserNamesAccountProfiling	json_extract(service, "$.additionalInfo.profiledBehavior.rareProfiledUserNamesAccountProfiling")	
service_additionalInfo_profiledBehavior_rareProfiledUserNamesBucketProfiling	json_extract(service, "$.additionalInfo.profiledBehavior.rareProfiledUserNamesBucketProfiling")	
service_additionalInfo_profiledBehavior_rareProfiledUserTypesAccountProfiling	json_extract(service, "$.additionalInfo.profiledBehavior.rareProfiledUserTypesAccountProfiling")	
service_additionalInfo_recentCredentials_accessKeyId	json_extract(service, "$.additionalInfo.recentCredentials.accessKeyId")	
service_additionalInfo_recentCredentials_ipAddressV4	json_extract(service, "$.additionalInfo.recentCredentials.ipAddressV4")	
service_additionalInfo_recentCredentials_principalId	json_extract(service, "$.additionalInfo.recentCredentials.principalId")	
service_additionalInfo_remotePort	json_extract(service, "$.additionalInfo.remotePort")	
service_additionalInfo_sample	json_extract(service, "$.additionalInfo.sample")	
service_additionalInfo_scannedPort	json_extract(service, "$.additionalInfo.scannedPort")	
service_additionalInfo_threatListName	json_extract(service, "$.additionalInfo.threatListName")	
service_additionalInfo_threatName	json_extract(service, "$.additionalInfo.threatName")	
service_additionalInfo_type	json_extract(service, "$.additionalInfo.type")	
service_additionalInfo_unusual	json_extract(service, "$.additionalInfo.unusual")	
service_additionalInfo_unusual_countries	json_extract(service, "$.additionalInfo.unusual.countries")	
service_additionalInfo_unusual_hoursOfDay	json_extract(service, "$.additionalInfo.unusual.hoursOfDay")	
service_additionalInfo_unusual_isps	json_extract(service, "$.additionalInfo.unusual.isps")	
service_additionalInfo_unusual_userNames	json_extract(service, "$.additionalInfo.unusual.userNames")	
service_additionalInfo_unusualBehavior_isUnusualUserIdentity	json_extract(service, "$.additionalInfo.unusualBehavior.isUnusualUserIdentity")	
service_additionalInfo_unusualBehavior_numberOfPast24HoursAPIsBucketProfiling	json_extract(service, "$.additionalInfo.unusualBehavior.numberOfPast24HoursAPIsBucketProfiling")	
service_additionalInfo_unusualBehavior_numberOfPast24HoursAPIsBucketUserIdentityProfiling	json_extract(service, "$.additionalInfo.unusualBehavior.numberOfPast24HoursAPIsBucketUserIdentityProfiling")	
service_additionalInfo_unusualBehavior_numberOfPast24HoursAPIsUserIdentityProfiling	json_extract(service, "$.additionalInfo.unusualBehavior.numberOfPast24HoursAPIsUserIdentityProfiling")	
service_additionalInfo_unusualBehavior_unusualAPIsAccountProfiling	json_extract(service, "$.additionalInfo.unusualBehavior.unusualAPIsAccountProfiling")	
service_additionalInfo_unusualBehavior_unusualAPIsUserIdentityProfiling	json_extract(service, "$.additionalInfo.unusualBehavior.unusualAPIsUserIdentityProfiling")	
service_additionalInfo_unusualBehavior_unusualASNClusterProfiling_asnOrg	json_extract(service, "$.additionalInfo.unusualBehavior.unusualASNClusterProfiling.asnOrg")	
service_additionalInfo_unusualBehavior_unusualASNClusterProfiling_failedLoginCount	json_extract(service, "$.additionalInfo.unusualBehavior.unusualASNClusterProfiling.failedLoginCount")	
service_additionalInfo_unusualBehavior_unusualASNClusterProfiling_incompleteConnectionCount	json_extract(service, "$.additionalInfo.unusualBehavior.unusualASNClusterProfiling.incompleteConnectionCount")	
service_additionalInfo_unusualBehavior_unusualASNClusterProfiling_successfulLoginCount	json_extract(service, "$.additionalInfo.unusualBehavior.unusualASNClusterProfiling.successfulLoginCount")	
service_additionalInfo_unusualBehavior_unusualASNsAccountProfiling	json_extract(service, "$.additionalInfo.unusualBehavior.unusualASNsAccountProfiling")	
service_additionalInfo_unusualBehavior_unusualASNsBucketProfiling	json_extract(service, "$.additionalInfo.unusualBehavior.unusualASNsBucketProfiling")	
service_additionalInfo_unusualBehavior_unusualASNsUserIdentityProfiling	json_extract(service, "$.additionalInfo.unusualBehavior.unusualASNsUserIdentityProfiling")	
service_additionalInfo_unusualBehavior_unusualApplicationNameClusterProfiling_applicationName	json_extract(service, "$.additionalInfo.unusualBehavior.unusualApplicationNameClusterProfiling.applicationName")	
service_additionalInfo_unusualBehavior_unusualApplicationNameClusterProfiling_failedLoginCount	json_extract(service, "$.additionalInfo.unusualBehavior.unusualApplicationNameClusterProfiling.failedLoginCount")	
service_additionalInfo_unusualBehavior_unusualApplicationNameClusterProfiling_incompleteConnectionCount	json_extract(service, "$.additionalInfo.unusualBehavior.unusualApplicationNameClusterProfiling.incompleteConnectionCount")	
service_additionalInfo_unusualBehavior_unusualApplicationNameClusterProfiling_successfulLoginCount	json_extract(service, "$.additionalInfo.unusualBehavior.unusualApplicationNameClusterProfiling.successfulLoginCount")	
service_additionalInfo_unusualBehavior_unusualBucketsAccountProfiling	json_extract(service, "$.additionalInfo.unusualBehavior.unusualBucketsAccountProfiling")	
service_additionalInfo_unusualBehavior_unusualBucketsUserIdentityProfiling	json_extract(service, "$.additionalInfo.unusualBehavior.unusualBucketsUserIdentityProfiling")	
service_additionalInfo_unusualBehavior_unusualDatabaseNameClusterProfiling_databaseName	json_extract(service, "$.additionalInfo.unusualBehavior.unusualDatabaseNameClusterProfiling.databaseName")	
service_additionalInfo_unusualBehavior_unusualDatabaseNameClusterProfiling_failedLoginCount	json_extract(service, "$.additionalInfo.unusualBehavior.unusualDatabaseNameClusterProfiling.failedLoginCount")	
service_additionalInfo_unusualBehavior_unusualDatabaseNameClusterProfiling_incompleteConnectionCount	json_extract(service, "$.additionalInfo.unusualBehavior.unusualDatabaseNameClusterProfiling.incompleteConnectionCount")	
service_additionalInfo_unusualBehavior_unusualDatabaseNameClusterProfiling_successfulLoginCount	json_extract(service, "$.additionalInfo.unusualBehavior.unusualDatabaseNameClusterProfiling.successfulLoginCount")	
service_additionalInfo_unusualBehavior_unusualUserAgentsAccountProfiling	json_extract(service, "$.additionalInfo.unusualBehavior.unusualUserAgentsAccountProfiling")	
service_additionalInfo_unusualBehavior_unusualUserAgentsUserIdentityProfiling	json_extract(service, "$.additionalInfo.unusualBehavior.unusualUserAgentsUserIdentityProfiling")	
service_additionalInfo_unusualBehavior_unusualUserNameClusterProfiling_failedLoginCount	json_extract(service, "$.additionalInfo.unusualBehavior.unusualUserNameClusterProfiling.failedLoginCount")	
service_additionalInfo_unusualBehavior_unusualUserNameClusterProfiling_incompleteConnectionCount	json_extract(service, "$.additionalInfo.unusualBehavior.unusualUserNameClusterProfiling.incompleteConnectionCount")	
service_additionalInfo_unusualBehavior_unusualUserNameClusterProfiling_successfulLoginCount	json_extract(service, "$.additionalInfo.unusualBehavior.unusualUserNameClusterProfiling.successfulLoginCount")	
service_additionalInfo_unusualBehavior_unusualUserNameClusterProfiling_userName	json_extract(service, "$.additionalInfo.unusualBehavior.unusualUserNameClusterProfiling.userName")	
service_additionalInfo_unusualBehavior_unusualUserNamesAccountProfiling	json_extract(service, "$.additionalInfo.unusualBehavior.unusualUserNamesAccountProfiling")	
service_additionalInfo_unusualBehavior_unusualUserNamesBucketProfiling	json_extract(service, "$.additionalInfo.unusualBehavior.unusualUserNamesBucketProfiling")	
service_additionalInfo_unusualBehavior_unusualUserTypesAccountProfiling	json_extract(service, "$.additionalInfo.unusualBehavior.unusualUserTypesAccountProfiling")	
service_additionalInfo_unusualProtocol	json_extract(service, "$.additionalInfo.unusualProtocol")	
service_additionalInfo_userAgent_fullUserAgent	json_extract(service, "$.additionalInfo.userAgent.fullUserAgent")	
service_additionalInfo_userAgent_userAgentCategory	json_extract(service, "$.additionalInfo.userAgent.userAgentCategory")	
service_additionalInfo_value	json_extract(service, "$.additionalInfo.value")	
service_archived	json_extract(service, "$.archived")	
service_count	json_extract(service, "$.count")	
service_detection_anomaly_profiles_GeneratedFindingScope1_GeneratedFindingFeature1_observations_text	json_extract(service, "$.detection.anomaly.profiles.GeneratedFindingScope1.GeneratedFindingFeature1.observations.text")	
service_detection_anomaly_profiles_GeneratedFindingScope1_GeneratedFindingFeature1_profileSubtype	json_extract(service, "$.detection.anomaly.profiles.GeneratedFindingScope1.GeneratedFindingFeature1.profileSubtype")	
service_detection_anomaly_profiles_GeneratedFindingScope1_GeneratedFindingFeature1_profileType	json_extract(service, "$.detection.anomaly.profiles.GeneratedFindingScope1.GeneratedFindingFeature1.profileType")	
service_detection_anomaly_profiles_GeneratedFindingScope2_GeneratedFindingFeature1_observations_text	json_extract(service, "$.detection.anomaly.profiles.GeneratedFindingScope2.GeneratedFindingFeature1.observations.text")	
service_detection_anomaly_profiles_GeneratedFindingScope2_GeneratedFindingFeature1_profileSubtype	json_extract(service, "$.detection.anomaly.profiles.GeneratedFindingScope2.GeneratedFindingFeature1.profileSubtype")	
service_detection_anomaly_profiles_GeneratedFindingScope2_GeneratedFindingFeature1_profileType	json_extract(service, "$.detection.anomaly.profiles.GeneratedFindingScope2.GeneratedFindingFeature1.profileType")	
service_detection_anomaly_unusual_behavior_GeneratedFindingScope1_GeneratedFindingFeature1_observations_text	json_extract(service, "$.detection.anomaly.unusual.behavior.GeneratedFindingScope1.GeneratedFindingFeature1.observations.text")	
service_detection_anomaly_unusual_behavior_GeneratedFindingScope1_GeneratedFindingFeature1_profileSubtype	json_extract(service, "$.detection.anomaly.unusual.behavior.GeneratedFindingScope1.GeneratedFindingFeature1.profileSubtype")	
service_detection_anomaly_unusual_behavior_GeneratedFindingScope1_GeneratedFindingFeature1_profileType	json_extract(service, "$.detection.anomaly.unusual.behavior.GeneratedFindingScope1.GeneratedFindingFeature1.profileType")	
service_detection_anomaly_unusual_behavior_GeneratedFindingScope2_GeneratedFindingFeature1_observations_text	json_extract(service, "$.detection.anomaly.unusual.behavior.GeneratedFindingScope2.GeneratedFindingFeature1.observations.text")	
service_detection_anomaly_unusual_behavior_GeneratedFindingScope2_GeneratedFindingFeature1_profileSubtype	json_extract(service, "$.detection.anomaly.unusual.behavior.GeneratedFindingScope2.GeneratedFindingFeature1.profileSubtype")	
service_detection_anomaly_unusual_behavior_GeneratedFindingScope2_GeneratedFindingFeature1_profileType	json_extract(service, "$.detection.anomaly.unusual.behavior.GeneratedFindingScope2.GeneratedFindingFeature1.profileType")	
service_detection_anomaly_unusual_volume	json_extract(service, "$.detection.anomaly.unusual.volume")	
service_detectorId	json_extract(service, "$.detectorId")	
service_ebsVolumeScanDetails_scanCompletedAt	json_extract(service, "$.ebsVolumeScanDetails.scanCompletedAt")	
service_ebsVolumeScanDetails_scanDetections_highestSeverityThreatDetails_count	json_extract(service, "$.ebsVolumeScanDetails.scanDetections.highestSeverityThreatDetails.count")	
service_ebsVolumeScanDetails_scanDetections_highestSeverityThreatDetails_severity	json_extract(service, "$.ebsVolumeScanDetails.scanDetections.highestSeverityThreatDetails.severity")	
service_ebsVolumeScanDetails_scanDetections_highestSeverityThreatDetails_threatName	json_extract(service, "$.ebsVolumeScanDetails.scanDetections.highestSeverityThreatDetails.threatName")	
service_ebsVolumeScanDetails_scanDetections_scannedItemCount_files	json_extract(service, "$.ebsVolumeScanDetails.scanDetections.scannedItemCount.files")	
service_ebsVolumeScanDetails_scanDetections_scannedItemCount_totalGb	json_extract(service, "$.ebsVolumeScanDetails.scanDetections.scannedItemCount.totalGb")	
service_ebsVolumeScanDetails_scanDetections_scannedItemCount_volumes	json_extract(service, "$.ebsVolumeScanDetails.scanDetections.scannedItemCount.volumes")	
service_ebsVolumeScanDetails_scanDetections_threatDetectedByName_itemCount	json_extract(service, "$.ebsVolumeScanDetails.scanDetections.threatDetectedByName.itemCount")	
service_ebsVolumeScanDetails_scanDetections_threatDetectedByName_shortened	json_extract(service, "$.ebsVolumeScanDetails.scanDetections.threatDetectedByName.shortened")	
service_ebsVolumeScanDetails_scanDetections_threatDetectedByName_threatNames_filePaths_fileName	json_extract(service, "$.ebsVolumeScanDetails.scanDetections.threatDetectedByName.threatNames.filePaths.fileName")	
service_ebsVolumeScanDetails_scanDetections_threatDetectedByName_threatNames_filePaths_filePath	json_extract(service, "$.ebsVolumeScanDetails.scanDetections.threatDetectedByName.threatNames.filePaths.filePath")	
service_ebsVolumeScanDetails_scanDetections_threatDetectedByName_threatNames_filePaths_hash	json_extract(service, "$.ebsVolumeScanDetails.scanDetections.threatDetectedByName.threatNames.filePaths.hash")	
service_ebsVolumeScanDetails_scanDetections_threatDetectedByName_threatNames_filePaths_volumeArn	json_extract(service, "$.ebsVolumeScanDetails.scanDetections.threatDetectedByName.threatNames.filePaths.volumeArn")	
service_ebsVolumeScanDetails_scanDetections_threatDetectedByName_threatNames_itemCount	json_extract(service, "$.ebsVolumeScanDetails.scanDetections.threatDetectedByName.threatNames.itemCount")	
service_ebsVolumeScanDetails_scanDetections_threatDetectedByName_threatNames_name	json_extract(service, "$.ebsVolumeScanDetails.scanDetections.threatDetectedByName.threatNames.name")	
service_ebsVolumeScanDetails_scanDetections_threatDetectedByName_threatNames_severity	json_extract(service, "$.ebsVolumeScanDetails.scanDetections.threatDetectedByName.threatNames.severity")	
service_ebsVolumeScanDetails_scanDetections_threatDetectedByName_uniqueThreatNameCount	json_extract(service, "$.ebsVolumeScanDetails.scanDetections.threatDetectedByName.uniqueThreatNameCount")	
service_ebsVolumeScanDetails_scanDetections_threatsDetectedItemCount_files	json_extract(service, "$.ebsVolumeScanDetails.scanDetections.threatsDetectedItemCount.files")	
service_ebsVolumeScanDetails_scanId	json_extract(service, "$.ebsVolumeScanDetails.scanId")	
service_ebsVolumeScanDetails_scanStartedAt	json_extract(service, "$.ebsVolumeScanDetails.scanStartedAt")	
service_ebsVolumeScanDetails_scanType	json_extract(service, "$.ebsVolumeScanDetails.scanType")	
service_ebsVolumeScanDetails_sources	json_extract(service, "$.ebsVolumeScanDetails.sources")	
service_ebsVolumeScanDetails_triggerFindingId	json_extract(service, "$.ebsVolumeScanDetails.triggerFindingId")	
service_eventFirstSeen	json_extract(service, "$.eventFirstSeen")	
service_eventLastSeen	json_extract(service, "$.eventLastSeen")	
service_evidence	json_extract(service, "$.evidence")	
service_evidence_threatIntelligenceDetails_threatListName	json_extract(service, "$.evidence.threatIntelligenceDetails.threatListName")	
service_evidence_threatIntelligenceDetails_threatNames	json_extract(service, "$.evidence.threatIntelligenceDetails.threatNames")	
service_featureName	json_extract(service, "$.featureName")	
service_resourceRole	json_extract(service, "$.resourceRole")	
service_runtimeDetails_context_commandLineExample	json_extract(service, "$.runtimeDetails.context.commandLineExample")	
service_runtimeDetails_context_libraryPath	json_extract(service, "$.runtimeDetails.context.libraryPath")	
service_runtimeDetails_context_modifyingProcess_cmdLine	json_extract(service, "$.runtimeDetails.context.modifyingProcess.cmdLine")	
service_runtimeDetails_context_modifyingProcess_euid	json_extract(service, "$.runtimeDetails.context.modifyingProcess.euid")	
service_runtimeDetails_context_modifyingProcess_executablePath	json_extract(service, "$.runtimeDetails.context.modifyingProcess.executablePath")	
service_runtimeDetails_context_modifyingProcess_executableSha256	json_extract(service, "$.runtimeDetails.context.modifyingProcess.executableSha256")	
service_runtimeDetails_context_modifyingProcess_name	json_extract(service, "$.runtimeDetails.context.modifyingProcess.name")	
service_runtimeDetails_context_modifyingProcess_parentUuid	json_extract(service, "$.runtimeDetails.context.modifyingProcess.parentUuid")	
service_runtimeDetails_context_modifyingProcess_pid	json_extract(service, "$.runtimeDetails.context.modifyingProcess.pid")	
service_runtimeDetails_context_modifyingProcess_pwd	json_extract(service, "$.runtimeDetails.context.modifyingProcess.pwd")	
service_runtimeDetails_context_modifyingProcess_startTime	json_extract(service, "$.runtimeDetails.context.modifyingProcess.startTime")	
service_runtimeDetails_context_modifyingProcess_user	json_extract(service, "$.runtimeDetails.context.modifyingProcess.user")	
service_runtimeDetails_context_modifyingProcess_userId	json_extract(service, "$.runtimeDetails.context.modifyingProcess.userId")	
service_runtimeDetails_context_modifyingProcess_uuid	json_extract(service, "$.runtimeDetails.context.modifyingProcess.uuid")	
service_runtimeDetails_context_mountSource	json_extract(service, "$.runtimeDetails.context.mountSource")	
service_runtimeDetails_context_mountTarget	json_extract(service, "$.runtimeDetails.context.mountTarget")	
service_runtimeDetails_context_releaseAgentPath	json_extract(service, "$.runtimeDetails.context.releaseAgentPath")	
service_runtimeDetails_context_runcBinaryPath	json_extract(service, "$.runtimeDetails.context.runcBinaryPath")	
service_runtimeDetails_context_scriptPath	json_extract(service, "$.runtimeDetails.context.scriptPath")	
service_runtimeDetails_context_serviceName	json_extract(service, "$.runtimeDetails.context.$Name")	
service_runtimeDetails_context_socketPath	json_extract(service, "$.runtimeDetails.context.socketPath")	
service_runtimeDetails_context_targetProcess_cmdLine	json_extract(service, "$.runtimeDetails.context.targetProcess.cmdLine")	
service_runtimeDetails_context_targetProcess_euid	json_extract(service, "$.runtimeDetails.context.targetProcess.euid")	
service_runtimeDetails_context_targetProcess_executablePath	json_extract(service, "$.runtimeDetails.context.targetProcess.executablePath")	
service_runtimeDetails_context_targetProcess_executableSha256	json_extract(service, "$.runtimeDetails.context.targetProcess.executableSha256")	
service_runtimeDetails_context_targetProcess_lineage_euid	json_extract(service, "$.runtimeDetails.context.targetProcess.lineage.euid")	
service_runtimeDetails_context_targetProcess_lineage_executablePath	json_extract(service, "$.runtimeDetails.context.targetProcess.lineage.executablePath")	
service_runtimeDetails_context_targetProcess_lineage_parentUuid	json_extract(service, "$.runtimeDetails.context.targetProcess.lineage.parentUuid")	
service_runtimeDetails_context_targetProcess_lineage_pid	json_extract(service, "$.runtimeDetails.context.targetProcess.lineage.pid")	
service_runtimeDetails_context_targetProcess_lineage_uuid	json_extract(service, "$.runtimeDetails.context.targetProcess.lineage.uuid")	
service_runtimeDetails_context_targetProcess_name	json_extract(service, "$.runtimeDetails.context.targetProcess.name")	
service_runtimeDetails_context_targetProcess_parentUuid	json_extract(service, "$.runtimeDetails.context.targetProcess.parentUuid")	
service_runtimeDetails_context_targetProcess_pid	json_extract(service, "$.runtimeDetails.context.targetProcess.pid")	
service_runtimeDetails_context_targetProcess_pwd	json_extract(service, "$.runtimeDetails.context.targetProcess.pwd")	
service_runtimeDetails_context_targetProcess_startTime	json_extract(service, "$.runtimeDetails.context.targetProcess.startTime")	
service_runtimeDetails_context_targetProcess_user	json_extract(service, "$.runtimeDetails.context.targetProcess.user")	
service_runtimeDetails_context_targetProcess_userId	json_extract(service, "$.runtimeDetails.context.targetProcess.userId")	
service_runtimeDetails_context_targetProcess_uuid	json_extract(service, "$.runtimeDetails.context.targetProcess.uuid")	
service_runtimeDetails_context_threatFilePath	json_extract(service, "$.runtimeDetails.context.threatFilePath")	
service_runtimeDetails_context_toolCategory	json_extract(service, "$.runtimeDetails.context.toolCategory")	
service_runtimeDetails_context_toolName	json_extract(service, "$.runtimeDetails.context.toolName")	
service_runtimeDetails_process_cmdLine	json_extract(service, "$.runtimeDetails.process.cmdLine")	
service_runtimeDetails_process_euid	json_extract(service, "$.runtimeDetails.process.euid")	
service_runtimeDetails_process_executablePath	json_extract(service, "$.runtimeDetails.process.executablePath")	
service_runtimeDetails_process_executableSha256	json_extract(service, "$.runtimeDetails.process.executableSha256")	
service_runtimeDetails_process_lineage_euid	json_extract(service, "$.runtimeDetails.process.lineage.euid")	
service_runtimeDetails_process_lineage_executablePath	json_extract(service, "$.runtimeDetails.process.lineage.executablePath")	
service_runtimeDetails_process_lineage_name	json_extract(service, "$.runtimeDetails.process.lineage.name")	
service_runtimeDetails_process_lineage_namespacePid	json_extract(service, "$.runtimeDetails.process.lineage.namespacePid")	
service_runtimeDetails_process_lineage_parentUuid	json_extract(service, "$.runtimeDetails.process.lineage.parentUuid")	
service_runtimeDetails_process_lineage_pid	json_extract(service, "$.runtimeDetails.process.lineage.pid")	
service_runtimeDetails_process_lineage_startTime	json_extract(service, "$.runtimeDetails.process.lineage.startTime")	
service_runtimeDetails_process_lineage_userId	json_extract(service, "$.runtimeDetails.process.lineage.userId")	
service_runtimeDetails_process_lineage_uuid	json_extract(service, "$.runtimeDetails.process.lineage.uuid")	
service_runtimeDetails_process_name	json_extract(service, "$.runtimeDetails.process.name")	
service_runtimeDetails_process_parentUuid	json_extract(service, "$.runtimeDetails.process.parentUuid")	
service_runtimeDetails_process_pid	json_extract(service, "$.runtimeDetails.process.pid")	
service_runtimeDetails_process_pwd	json_extract(service, "$.runtimeDetails.process.pwd")	
service_runtimeDetails_process_startTime	json_extract(service, "$.runtimeDetails.process.startTime")	
service_runtimeDetails_process_user	json_extract(service, "$.runtimeDetails.process.user")	
service_runtimeDetails_process_userId	json_extract(service, "$.runtimeDetails.process.userId")	
service_runtimeDetails_process_uuid	json_extract(service, "$.runtimeDetails.process.uuid")	
service_serviceName	json_extract(service, "$.Name")	
service_malwarescandetails_threats_itemPaths_name	json_extract_scalar(service, "$.malwareScanDetails.threats[0].name")	
service_malwarescandetails_threats_itemPaths_source	json_extract_scalar(service, "$.malwareScanDetails.threats[0].source")	
service_malwarescandetails_threats_itemPaths_hash	json_extract_scalar(service, "$.malwareScanDetails.threats[0].itemPaths[0].hash")	
service_malwarescandetails_threats_itemPaths_nestedItemPath	json_extract_scalar(service, "$.malwareScanDetails.threats[0].itemPaths[0].nestedItemPath")	
service_runtimedetails_context_neweuid	json_extract_scalar(service, "$.runtimeDetails.context.newEuid")	
service_runtimedetails_context_oldeuid	json_extract_scalar(service, "$.runtimeDetails.context.oldEuid")	
resource_accessKeyDetails_Server	json_extract(resource, "$.accessKeyDetails.userName")	
resource_instanceDetails_tags_value_owner	arrayindex(arrayfilter(json_extract_array(resource, "$.instanceDetails.tags"),"@element" contains "Owner"),0) -> valu	
Effective_Permission	resource_s3BucketDetails_publicAccess_effectivePermission	
Acct_Block_Public_ACLs	resource_s3BucketDetails_publicAccess_permissionConfiguration_accountLevelPermissions_blockPublicAccess_blockPublicAcls	
Acct_Block_Public_Policy	resource_s3BucketDetails_publicAccess_permissionConfiguration_accountLevelPermissions_blockPublicAccess_blockPublicPolicy	
Acct_Ignore_Public_ACLs	resource_s3BucketDetails_publicAccess_permissionConfiguration_accountLevelPermissions_blockPublicAccess_ignorePublicAcls	
Acct_Restrict_Public_Buckets	resource_s3BucketDetails_publicAccess_permissionConfiguration_accountLevelPermissions_blockPublicAccess_restrictPublicBuckets	
Buck_Block_Public_ACLs	resource_s3BucketDetails_publicAccess_permissionConfiguration_bucketLevelPermissions_blockPublicAccess_blockPublicAcls	
Buck_Block_Public_Policy	resource_s3BucketDetails_publicAccess_permissionConfiguration_bucketLevelPermissions_blockPublicAccess_blockPublicPolicy	
Buck_Ignore_Public_ACLs	resource_s3BucketDetails_publicAccess_permissionConfiguration_bucketLevelPermissions_blockPublicAccess_ignorePublicAcls	
Buck_Restrict_Public_Buckets	resource_s3BucketDetails_publicAccess_permissionConfiguration_bucketLevelPermissions_blockPublicAccess_restrictPublicBuckets	
DNS_Action_Blocked	service_action_dnsRequestAction_blocked	
Request_Domain	service_action_dnsRequestAction_domain	
Instance_Details_Key	resource_instanceDetails_tags_key	
Instance_Details_Value	resource_instanceDetails_tags_value	
Port_Probe_Remote_ISP	service_action_portProbeAction_portProbeDetails_remoteIpDetails_organization_isp	
Port_Probe_Remote_Ip	service_action_portProbeAction_portProbeDetails_remoteIpDetails_ipAddressV4	
Network_Connect_Remote_Ip	service_action_networkConnectionAction_remoteIpDetails_ipAddressV4	
Scanning_Ports	service_action_portProbeAction_portProbeDetails_localPortDetails_port	
InstanceID	resource_instanceDetails_instanceId	
subnet_id	resource_instanceDetails_networkInterfaces_subnetId	
eks_vpc_id	resource_eksClusterDetails_vpcId	
vpc_id	resource_instanceDetails_networkInterfaces_vpcId	
network_interface_id	resource_instanceDetails_networkInterfaces_networkInterfaceId	
eks_api_requestUri	service_action_kubernetesApiCallAction_requestUri	
instance_type	resource_instanceDetails_instanceType	
image_id	resource_instanceDetails_imageId	
eks_username	resource_kubernetesDetails_kubernetesUserDetails_username	
eks_uid	resource_kubernetesDetails_kubernetesUserDetails_uid	
eks_cluster_name	resource_eksClusterDetails_name	
eks_cluster_status	resource_eksClusterDetails_status	
eks_api_call_remote_ip	service_action_kubernetesApiCallAction_remoteIpDetails_ipAddressV4	
eks_api_call_source_ip	service_action_kubernetesApiCallAction_sourceIPs	
access_key_principalId	resource_accessKeyDetails_principalId	
ImageDescription	resource_instanceDetails_imageDescription	
Traffic	service_action_networkConnectionAction_connectionDirection	
ProbeLocalPort	service_action_portProbeAction_portProbeDetails_localPortDetails_port	
ScannedPort	service_additionalInfo_scannedPort	
Network_Local_IP	service_action_networkConnectionAction_localIpDetails_ipAddressV4	
RDS_Remote_Ip	service_action_rdsLoginAttemptAction_remoteIpDetails_ipAddressV4	
Resource_Name	coalesce(resource_instanceDetails_iamInstanceProfile_arn, resource_s3BucketDetails_arn, resource_lambdaDetails_functionArn, resource_containerDetails_name, resource_ecsClusterDetails_arn, resource_ecsClusterDetails_taskDetails_arn, resource_rdsDbInstanceDetails_dbInstanceArn, service_action_awsApiCallAction_affectedResources_AWS__CloudTrail__Trail, service_action_awsApiCallAction_affectedResources_AWS__EC2__Instance, service_action_awsApiCallAction_affectedResources_AWS__S3__Bucket, resource_ebsVolumeDetails_scannedVolumeDetails_volumeArn, resource_ebsVolumeDetails_skippedVolumeDetails_volumeArn, resource_instanceDetails_outpostArn, service_runtimeDetails_process_name, Instance_Details_Value, service_action_kubernetesapicallaction_resourcename, eks_cluster_name, access_key_principalid, resource_instancedetails_instanceid)	
Username	resource_accessKeyDetails_userName	
Private_DNS_Name	resource_instanceDetails_networkInterfaces_privateDnsName	
Bucket_Name	resource_s3BucketDetails_arn	
API_Call	service_action_awsApiCallAction_api	
Owner	resource_instanceDetails_tags_value_owner	
DetectorID	service_detectorId	
API_Call_Remote_Ip	service_action_awsApiCallAction_remoteIpDetails_ipAddressV4	
PrivateIpAddress	resource_instanceDetails_networkInterfaces_privateIpAddress	
AssumeRole	service_additionalInfo_profiledBehavior_frequentProfiledUserNamesAccountProfiling	
Network_Remote_IP	service_action_rdsLoginAttemptAction_remoteIpDetails_ipAddressV4	
userIdentity_principalId	resource_accessKeyDetails_principalId	
Server	resource_accessKeyDetails_Server	
Request_Domain	coalesce(service_action_dnsRequestAction_domain, service_action_awsapicallaction_domaindetails_domain, service_action_awsApiCallAction_serviceName, api_call_remote_ip, service_action_networkConnectionAction_remoteIpDetails_ipAddressV4, eks_api_requesturi, RDS_Remote_Ip, service_ebsvolumescandetails_scandetections_highestseveritythreatdetails_threatname	
src_ip	coalesce(if(Traffic="OUTBOUND", Network_Local_IP, src_ip), API_Call_Remote_Ip, eks_api_call_remote_ip, RDS_Remote_Ip, Network_Connect_Remote_Ip, Port_Probe_Remote_Ip, PrivateIpAddress)	
src_host	coalesce(if(Traffic="OUTBOUND", InstanceID, src_host), Private_DNS_Name, API_Call_Remote_Ip, Network_Connect_Remote_Ip, Port_Probe_Remote_Ip, Server, eks_api_call_remote_ip, eks_vpc_id, resource_ecsclusterdetails_name, resource_rdsdbinstancedetails_dbclusteridentifier, resource_instanceDetails_instanceId )	
dest_ip	coalesce(if(Traffic="OUTBOUND", Network_Connect_Remote_Ip, dest_ip), Network_Remote_IP, Network_Local_IP, eks_api_call_source_ip, Request_Domain, PrivateIpAddress),	
dest_host	coalesce(if(Traffic="OUTBOUND", Network_Connect_Remote_Ip, dest_host), Request_Domain, Server, InstanceID, eks_cluster_name)	
